-----------------------------------------------------------------------------------------------------------------------------------------------XXXXXXX----------------------------------------------------------------------------------------
----------------------------------------------------------------------------------------------------------------------------------------------------------------------------------------------------------------------------------------------
--------------------------XXXXXXXXXXXXXXXXXXXXXXXXXXXXXXXXXXXXXXXXXXXXXXXXXXXXXXXX----------------------------------------------------------------------XXXXXXXXXXXX--------------------------------------------------------------------------
----------------------------------------------------------------------------------------------------------------------------------------------------------------------------------------------------------------------------------------------
-------------------------------------------------------------------------------------------------LXXXXXXXXXXXXXXXXXXXXXXXXXXXXXXXXXXX---------------------------------------------------------------------------------------------------------
----------------------------------------------------------------------------------------------------------------------------------------------------------------------------------------------------------------------------------------------
----------------------------------------------------------------------------------------------------------------------------------------------------------------------XXXXXXXXXXX-------------------------------------------------------------
----------------------------------------------------------------------------------------------------------------------------------------------------------------------------------------------------------------------------------------------
---------------------------------------------------------------N------------------------XXXX------------------------------------B-------------------------------------------------------------------------------------------------------------
-----------------------------------------------------------XXXXXXXXXX----------------XXX------------------------XXXXXXXXXXXXXXXXXXXXXXXXXXXXXX--------------------------------------XXXXXXXX--------------------------------------------------
--------------------------------B------------------------XX------------------------XX---------------------------------------------------------------------------------------------------------------------------------------------------------
----------------------------XXXXXXXX---------XXX-------XX-------------------S----XX-----------------------------------------------------------------------------------------------------------------------------------------------------------
-----------XXXXXXXX----V---------------------XXX-----XX-------------------XXXXXXX---------------XXXXXXX---------------------------------------------------------------------------------------------------------------------------------------
XXXXXXXXXXX--------XXXXXXXX---------XXXXXXXXXXXXXXXXX-----------XXXXXXXXXX---------------------------------------------------------------------------------XXXXXXXXX--------------------------------------------------------------------------