-----------------------------------------------------------------------------------------------------------------------------------------------------------------------------------------------------------------------------------------------------------------------------------
-----------------------------------------------------------------------------------------------------------------------------------------------------------------------------------------------------------------------------------------------------------------------------------
-----------------------------------------------------------------------------------------------------------------------------------------------------------------------------------------------------------------------------------------------------------------------------------
--------------------------------------------------------------------------------------------------------------T----------------F---------------------------------------------------------------------------------------------------------------------------------------------------
-----------------------------------------------------------------------------------------------------------cXXXXXX--------LXXXXXXXXXXl---------------------------------------------------------------------------------------------------------------------------------------------
-----------------------------------------------------------------------------------------------------------sDDB--------------------------------------------------------------------------------------------------------------------------------------------------------------------
-----------------------------------------------------------------------------------------------------------sDDB--------------------------------------------------------------------------------------------------------------------------------------------------------------------
-----------------------------------------------------------------------------------------------------------sddB--------------------------------------------------------------------------------------------------------------------------------------------------------------------
-------------------------------------------------------------------I---------------------------------------sDdB-------------------------------U------------------------------------------------------------------------------------------------------------------------------------
---------------------------------------------------------------cXXXXXXXXC----------------------------------sDDB--------------------------LXXXXXXXXXl-------------------------------------------------------------------------------------------------------------------------------
------------------------------------R------------------------cXeDDDDDDDDS----------------------------------sDDB---------------------------------------------------XXXXXXXXXXXXXXXXXXXXX--------------------------------------------------------------------------------------------
--------------------------------LXXXXXXl---------cXC-------cXeDDDDDDDDDDS-----------------------------v--V-sDDB--------------------------------------------------------------------------------------------------------------------------------------------------------------------
---------------cXXXXXXC-----v--------------------sDS-----cXeDDDDDDDDDDDDS-----LXXXXXl-------N-------XXXXXXXeDDB----------------------------------------------------------------------------------------------------------------------------------------------------------------------
----cXXXXXXXXXXeDDDDDDEXXXXXXXC---------cXXXXXXXXeDEXXXXXeDDDDDDDDDDDDDDS-----bDDDDDB----------------------bddB--------------------------------------------------------------------------------------------------------------------------------------------------------------------
WWWWedddddddddddddddddddddddddEWWWWWWWWWedddddddddddddddddddddddddddddddEWWWWWdddddddWWWWWWWWWWWWWWWWWWWWWWdddd--------------------------------------------------------------------------------------------------------------------------------------------------------------------
