-----------------------------------------------------------------------------------------------------------------------------------------------XXXXXXX----------------------------------------------------------------------------------------
----------------------------------------------------------------------------------------------------------------------------------------------------------------------------------------------------------------------------------------------
--------------------------XXXXXXXXXXXXXXXXXXXXXXXXXXXXXXXXXXXXXXXXXXXXXXXXXXXXXXXX----------------------------------------------------------------------XXXXXXXXXXXX--------------------------------------------------------------------------
----------------------------------------------------------------------------------------------------------------------------------------------------------------------------------------------------------------------------------------------
--------------------------------------------------------------------------------------------------XXXXXXXXXXXXXXXXXXXXXXXXXXXXXXXXXXX---------------------------------------------------------------------------------------------------------
----------------------------------------------------------------------------------------------------------------------------------------------------------------------------------------------------------------------------------------------
----------------------------------------------------------------------------------------------------------------------------------------------------------------------XXXXXXXXXXX-------------------------------------------------------------
----------------------------------------------------------------------------------------------------------------------------------------------------------------------------------------------------------------------------------------------
----------------------------------------------------------------------------------------XXXX--------------------------------------------------------------------------------------------------------------------------------------------------
-----------------------------------------------------------XXXXXXXXXX----------------XXX------------------------XXXXXXXXXXXXXXXXXXXXXXXXXXXXXX--------------------------------------XXXXXXXX--------------------------------------------------
---------------------------------------------------------XX------------------------XX---------------------------------------------------------------------------------------------------------------------------------------------------------
----------------------------XXXXXXXX---------XXX-------XX------------------------XX-----------------------------------------------------------------------------------------------------------------------------------------------------------
-----------XXXXXXXX--------------------------XXX-----XX-------------------XXXXXXX---------------XXXXXXX---------------------------------------------------------------------------------------------------------------------------------------
XXXXXXXXXXX--------XXXXXXXX---------XXXXXXXXXXXXXXXXX-----------XXXXXXXXXX---------------------------------------------------------------------------------XXXXXXXXX--------------------------------------------------------------------------