----------------------------------------------------------------------------------------------------------------------------------------------------------------------------------------------------------------------------------------------
----------------------------------------------------------------------------------------------------------------------------------------------------------------------------------------------------------------------------------------------
----------------------------------------------------------------------------------------------------------------------------------------------------------------------------------------------------------------------------------------------
----------------------------------------------------------------------------------------------------------------------------------------------------------------------------------------------------------------------------------------------
--------------------------------------------------------------------------------------------------XXXXXXXXXXXXXXXXXXXXXXXXXXXXXXXXXXX---------------------------------------------------------------------------------------------------------
----------------------------------------------------------------------------------------------------------------------------------------------------------------------------------------------------------------------------------------------
----------------------------------------------------------------------------------------------------------------------------------------------------------------------------------------------------------------------------------------------
----------------------------------------------------------------------------------------------------------------------------------------------------------------------------------------------------------------------------------------------
----------------------------------------------------------------------------------------XXXX--------------------------------------------------------------------------------------------------------------------------------------------------
-----------------------------------------------------------XXXXXXXXXX----------------XXXX-----------------------XXXXXXXXXXXXXXXXXXXXXXXXXXXXXX------------------------------------------------------------------------------------------------
---------------------------------------------------------XXDDDDDDDDDD--------------XXX--------------------------------------------------------------------------------------------------------------------------------------------------------
----------------------------XXXXXXXX---------XXX-------XXDDDDDDDDDDDD------------XXX----------------------------------------------------------------------------------------------------------------------------------------------------------
-----------XXXXXXXX--------------------------DDD-----XXDDDDDDDDDDDDDD-----XXXXXXXX--------------XXXXXXX---------------------------------------------------------------------------------------------------------------------------------------
XXXXXXXXXXXDDDDDDDDXXXXXXXX---------XXXXXXXXXDDDXXXXXDDDDDDDDDDDDDDDDXXXXX----------------------DDDDDDD---------------------------------------------------------------------------------------------------------------------------------------

