---------------------------------------------------------------------------------------------------------------------------------------------XXXXXXX------------------------------------------------------------------------------------------
------------------------------------R--------O----------I-----------------F-------------------------------------------------------------------------------------------------------------------------------------------------------------------
--------------------------XXXXXXXXXXXXXXXXXXXXXXXXXXXXXXXXXXXXXXXXXXXXXXXXXXXXXXXX----------------------------------------------------------------------XXXXXXXXXXXX--------------------------------------------------------------------------
----------------------------------------------------------------------------------------------------------------------------------------------------------------------------------------------------------------------------------------------
-------------------------------------------------------------------------------------------------LXXXXXXXXXXXXXXXXXXXXXXXXXXXXXXXXXXX---------------------------------------------------------------------------------------------------------
----------------------------------------------------------------------------------------------------------------------------------------------------------------------------------------------------------------------------------------------
----------------------------------------------------------------------------------------------------------------------------------------------------------------------------------------------------------------------------------------------
----------------------------------------------------------------------------------------------------------------------------------------------------------------------------------------------------------------------------------------------
---------------------------------------------------------------N------------------------XXXX----N-------------------------------B-------------------------------------------------------------------------------------------------------------
-----------------------------------------------------------XXXXXXXXXX----------------XXX------------------------XXXXXXXXXXXXXXXXXXXXXXXXXXXXXX--------------------------------------XXXXXXXX--------------------------------------------------
------------------N-----------S-B-------------S----------XX------------------------XX-----------------------P---------------------------------------------------------------------------------------------------------------------------------
--------P---X-w-------------XXXXXXXX---------XXX-------XX-------------------S----XX-----------------------------------------------------------------------------------------------------------------------------------------------------------
T--O-------SXXXXXXX----V---------------------XXX-----XX-------------------XXXXXXX---------------XXXXXXX---------------------------------------------------------------------------------------------------------------------------------------
XXXXXXXXXXXX-------XXXXXXXX---------XXXXXXXXXXXXXXXXX-----------XXXXXXXXXX---------------------------------------------------------------------------------XXXXXXXXX--------------------------------------------------------------------------
