-------------------------------------------------------------------------------------------------------------------------------------------------------------------------------------------------------------------------------------------------------------------------------
-------------------------------------------------------------------------------------------------------------------------------------------------------------------------------------------------------------------------------------------------------------------------------
-------------------------------------------------------------------------------------------------------------------------------------------------------------------------------------------------------------------------------------------------------------------------------
----------------------------------------------------------------------------------------------------------T----------------F---------------------------------------------------------------------------------------------------------------------------------------------------
-------------------------------------------------------------------------------------------------------cXXXXXX--------LXXXXXXXXXXl---------------------------------------------------------------------------------------------------------------------------------------------
-------------------------------------------------------------------------------------------------------sDDD--------------------------------------------------------------------------------------------------------------------------------------------------------------------
-------------------------------------------------------------------------------------------------------sDDd--------------------------------------------------------------------------------------------------------------------------------------------------------------------
-------------------------------------------------------------------------------------------------------sddD--------------------------------------------------------------------------------------------------------------------------------------------------------------------
---------------------------------------------------------------I---------------------------------------sDdd-------------------------------U------------------------------------------------------------------------------------------------------------------------------------
-----------------------------------------------------------cXXXXXXXXX----------------------------------sDDd--------------------------LXXXXXXXXXl-------------------------------------------------------------------------------------------------------------------------------
--------------------------------R------------------------cXeDDDDDDDDD----------------------------------sDDD---------------------------------------------------XXXXXXXXXXXXXXXXXXXXX--------------------------------------------------------------------------------------------
----------------N-----------LXXXXXXl---------cXC-------cXeDDDDDDDDDDD-----------------------------v--V-sDDD--------------------------------------------------------------------------------------------------------------------------------------------------------------------
-----------cXXXXXXC-----v--------------------sDS-----cXeDDDDDDDDDDDDD-----LXXXXXl-------N-------XXXXXXXeDDd--------------------------------------------------------------------------------------------------------------------------------------------------------------------
XXXXXXXXXXXeDDDDDDEXXXXXXXC---------cXXXXXXXXeDEXXXXXeDDDDDDDDDDDDDDD-----bDDDDDB----------------------dddd--------------------------------------------------------------------------------------------------------------------------------------------------------------------
ddddddddddddddddddddddddddEWWWWWWWWWeddddddddddddddddddddddddddddddddWWWWWdddddddWWWWWWWWWWWWWWWWWWWWWWdddd--------------------------------------------------------------------------------------------------------------------------------------------------------------------